set_freq,meas_freq,success,fail,total,voltage,time
224000000,223838208,1000000,0,1000000,1000,1943
224000000,223969280,1000000,0,1000000,1000,1951
224000000,223903744,1000000,0,1000000,1000,1969
224000000,224165888,1000000,0,1000000,1000,1971
224000000,224133120,1000000,0,1000000,1000,1963
224000000,223739904,1000000,0,1000000,1000,1964
224000000,223576064,1000000,0,1000000,1000,1969
224000000,223412224,1000000,0,1000000,1000,1970
224000000,223870976,1000000,0,1000000,1000,1962
224000000,224198656,1000000,0,1000000,1000,1962
225000000,227311616,382486,69,382555,1000,718
225000000,227540992,372090,72,372162,1000,694
225000000,227606528,450595,69,450664,1000,822
225000000,227377152,426857,70,426927,1000,789
225000000,226656256,363077,73,363150,1000,673
225000000,226852864,290064,78,290142,1000,541
225000000,226689024,535560,58,535618,1000,1001
225000000,227180544,401719,73,401792,1000,741
225000000,227180544,470672,64,470736,1000,876
225000000,227475456,356174,72,356246,1000,664
